%%%%%%%%%%%%%%%%%%%%%%%%%
%     %     %     %     %
%     %     %   .       %
%     %     %     %     % 
%%%%% %%% %%% %%%%%%%%%%%
%   %               %   %
%   %                   %
%   %  %%% %%%%%%%  %   %
%      %         %  %%%%%
%%%%%  %         %  %   %
%   %  %%%%%%%%%%%  %   %
%      %   %     %  %   %
%   %  %   %        %   %
%%%%%  %% %%%%%%%%  %% %%
%                       %
%                      P%
%% %%%% %%%%%%%% %%%%%%%%
%    %       %    %     %
%    %       %          %
%    %       %    %     %
%%%%%%%%%%%%%%%%%%%%%%%%%
